NO ./map/acacia_log.xpm

SO ./map/acacia_leaves.xpm
WE ./map/ea.xpm
EA ./map/acacia_log.xpm


F    1, 15,20
C 0,0,20

111111111111111
100000000000001
1010S0100011111111
100000100000001
111111111111111
     1
