NO ./textures/AnyConv.com__Bricks_22-512x512.xpm

SO ./textures/deepslate_copper_ore.xpm
WE ./textures/deepslate_diamond_ore.xpm
EA ./textures/deepslate_emerald_ore.xpm


F    1, 15,20
C 0,0,20

111111111111
1010S1111101111
111111111111
