NO ./textures/AnyConv.com__Bricks_22-512x512.xpm
SO ./textures/deepslate_copper_ore.xpm
WE ./textures/deepslate_diamond_ore.xpm
EA ./textures/deepslate_emerald_ore.xpm

F 255, 15,20
C 0,0,20

111111111111111111111
1000000000000000000001
10000N000011111111111
10000000001
11111111111
