NO ./map/acacia_log.xpm

SO ./map/acacia_log.xpm
WE ./map/acacia_log.xpm
EA ./map/acacia_log.xpm


F    1, 15,20
C 0,0,20

1111111111111
1000000000001
1010E111101111
1000000000001
111111111111
